XXXX  XXXXXXXX  XXXX
X                  X
X        XX        X
                    
                    
X                  X
X                  X
X   XX             X
X   XX             X
X                  X
X                  X
                    
                    
X                  X
X                  X
X    X             X
X                  X
X         X        X
X                  X
XXXX  XXXXXXXX  XXXX